11111111111111111111
1CCCC0000CCCC0000001
1CCCC0T00CCCC0T00001
1CCCC0T00CCCC0T00001
1CCCC0000CCCC0000001
10000CCCC0000CCCC001
10000CCCC0000CCCC001
10000CCCC0000CCCC001
10000CCCC0000CCCC001
10000000000000000001
10000000000000000001
10000000000000000001
10000T0000T000000001
10000T0000T000000001
10000T0000T000000PE1
11111111111111111111
