1111111111111111111111111111
1000000000000000000000000001
1000000000000000000000000001
100000000000CCCCC00000000001
10000000000000000000000010P1
1111111111111111111111111111
