11111111111111111111111111110
1000000P000000000000000000001
10000000000000000000000000001
100000C0000000000000000000001
100000000000000000000000E0001
11111111111111111111111111111
