11111
10101
1PEC1
10101
11111
