11110111
10100001
1P0C0001
101000E1
11111111
