1111111111111111111111111111111111
1P000000000000000000000001CCCCCCC1
100000000000C0000000000001CCCCCCC1
100000000000000000000000E1CCCCCCC1
1111111111111111111111111111111111
