111111111111111111111111111111
1P0000000000000000000000000001
100000000000CCCC00000000000001
100000000000000000000000000111
1000000000000000000000000001E1
111111111111111111111111111111
