11111111111111111
1P000000000000001
10000CCCC00000001
10000000000000111
100000000000001E1
11111111111111111
