1111111111111111111111111111
1E00000000000000000000000001
1000000000000000000000000001
100000000000CCCCC00000000001
1000000000000000000000001001
1111111111111111111111111111
