1111111111111111111111111111111111111111111111111111111
1000000000000000000000000000000000000000000000000000001
1000000000000000000000000000000000000000000000000000001
1000000000000000000000000000000000000000000000000000001
100000000000000000000000E000000000000000000000000000001
1000000000000000000000000000000000000000C000000C0000001
1000000000000000000000000000000000000000000000000000001
1P00000000000000000000000000000000000000000000000000001
1111111111111111111111111111111111111111111111111111111
