11111
1E001
10001
1P0C1
11111
