111111
1000C1
100111
1PE111
111111
